1111111111111111111
1P00001000001000001
11110000M0C01011101
10000001000C100C101
1011000000001111101
10C10001001000M0001
1001M00100001110001
10000C000M001C10001
1E0C000000000010001
1111111111111111111
