11111111111111111111
1C0000000C00000001E1
10001P000100C0110001
10001100010000000111
10111C00010001110011
100C00000000001C0001
11111111111111111111
