1111111111111111111
1P00001000001000001
1111000000C01011101
10000001000C100C101
1011000000001111101
10C1000100100000001
1001000100001110001
10000C0000001C10001
1E0C000000000010001
1111111111111111111
