1111111111111111111
1P00000000000000001
1111000000000000001
10000001000C0000011
1011000000000000001
10C1000100000010001
1001000100000010001
1000000000000C10001
1000000000000010001
1111111111111111111
