111111111111111111111111
100000000000000000000001
111100000000000000000011
100000010000000001000001
101100000000000000000001
100100010000001000000001
100100010000001000000001
100000000000001000000001
100000000000001000000001
111111111111111111111111
