1111111111111111111111111
10C00000C0001000000C001C1
11111C0000001000111110001
1C00000C10001C00000C10001
10C0000110001111111110001
11110000C001110C010000001
1000C0001001P1000000C0001
111111C110000001110000001
1100C0E00000C000C00000001
111000100100C111111000001
1C0000100C00000C000000001
1111111C01100000000011001
1C0000000000000C0000C00C1
1111111111111111111111111
