1111111111111111111111111
1P00000000001000000C00001
1111110000001000111110001
1000000000001C00000010001
10C0000000001111111110001
111100000000000C000000001
1000C000100000000000C0001
111111111000E000000000001
1000C00000000000C00000001
1000001000000111111000001
1C0000100C000000000000001
1111111C00000000000000001
1C000000000000000000C00C1
1111111111111111111111111
