111111
1P0001
100C01
10E001
111101
