111111111111111111111111111111111111111111111111111111111111111111111111111111111111111111111111
10C0CP00P00000000000000000000000000000000000000000000000000000000001C000000000000000000000000001
000000000000000000000000000000000000000000000000000000000000000000001000000000000000000000000E01
111111111111111111111111111111111111111111111111111111111111111111111111111111111111111111111111
