11111111111
10C0CP00001
10000000E01
11111111111
