1111111111111
1P00100MC0001
1C00CM00C0001
1CM0C000M0001
100E0000C0001
1111111111111
